
R         854  480

NO  ./txtrs/north.xpm

SO         ./txtrs/south.xpm










WE    ./txtrs/west.xpm

EA ./txtrs/east.xpm  

S  ./txtrs/sprite.xpm

F 105,105,105

C  0, 120      ,   255

        1111111111111111111111111
        1000000000112000000000021
        1011000001110000002000001
        1001000000000000000000001
111111111011000001112000000000211
100000000011000001110111110111111
11110111111111011100000010001
11110111111111011101010010001
11000000110101011100000010001
10000000000000000000000000001
10000000000000001101010010001
11000001110101011111011110N0111
11110111 1110101 101111010001
11111111 1111111 111111111111